53,55,59,61,60,58,54,52,
51,49,57,63,62,56,48,50,
35,33,41,47,46,40,32,34,
37,39,43,45,44,42,38,36,
04,06,10,12,13,11,07,05,
02,00,08,14,15,09,01,03,
18,16,24,30,31,25,17,19,
20,22,26,28,29,27,23,21,
