52,54,58,60,61,59,55,53,
50,48,56,62,63,57,49,51,
34,32,40,46,47,41,33,35,
36,38,42,44,45,43,39,37,
05,07,11,13,12,10,06,04,
03,01,09,15,14,08,00,02,
19,17,25,31,30,24,16,18,
21,23,27,29,28,26,22,20,
