53 55 59 61 60 58 54 52 
51 49 57 63 62 56 48 50 
35 33 41 47 46 40 32 34 
37 39 43 45 44 42 38 36 
5 7 11 13 12 10 6 4 
3 1 9 15 14 8 0 2 
19 17 25 31 30 24 16 18 
21 23 27 29 28 26 22 20 
